%%%%%%%%%%%%%%%%
%             P%
%              %
%              %
%              %
%              %
%              %
%.             %
%%%%%%%%%%%%%%%%